******************************************************************************
*..........................E.....E.....E.....E...............................*
*............................................................................*
*............................................................................*
*............................................................................*
*............................................................................*
*............................................................................*
*............................................................................*
*............................................................................*
*............................................................................*
*............................................................................*
*............................................................................*
*............................................................................*
*............................................................................*
*............................................................................*
*............................................................................*
*............................................................................*
*............................................................................*
*............................................................................*
*..................................P.........................................*
*............................................................................*
*............................................................................*
*............................................................................*
*............................................................................*
*............................................................................*
******************************************************************************
